2222222222
2000000002
2030000002
2000000002
2001000002
2000000002
2003000032
2004400042
2222222222
